abaft	afore	position	1
abeam	abeam	position	0
aboard	NULL	spatiotemporal/position	0
about	about	position/regarding	0
above	below	position	1
absent	absent	logic	0
across	across	spatiotemporal/position	0
afore	abaft	position/time	0
after	before	position/time	1
against	against	position/stance	0
along	along	spatiotemporal/position	0
alongside	alongside	position	0
amid	around	position	1
amidst	around	position	0
among	among	position	0
amongst	amongst	position	0
anenst	NULL	position/regarding	0
anent	NULL	position/regarding	0
anti	anti	stance	0
apropos	apropos	regarding	0
apud	apud	position	0
around	around	position	0
as	NULL	NULL	0
aside	aside	position	0
astride	between	position	1
at	NULL	position	0
athwart	athwart	position/stance	0
atop	beneath	position	1
bar	NULL	logic	0
barring	NULL	logic	0
before	after	position/time	0
behind	in_front_of	position	1
below	above	position	0
beneath	above	position	0
beside	beside	position	0
besides	besides	position	0
between	astride	position	0
beyond	inside	position	1
but	NULL	logic	0
by	by	position/time/means of achieving action	0
circa	NULL	time	0
concerning	NULL	regarding	0
considering	NULL	regarding	0
counting	NULL	logic	0
despite	NULL	regarding	0
down	NULL	position	0
during	NULL	time	0
except	NULL	logic	0
excepting	NULL	logic	0
excluding	NULL	logic	0
failing	NULL	logic	0
following	subsequent_to	time	1
for	~because_of	purpose	1
forenenst	forenenst	position	0
from	NULL	spatiotemporal/time	0
given	NULL	regarding	0
in	NULL	position/time	0
including	along_with	logic	1
inside	around	position	0
into	NULL	spatiotemporal	0
less	NULL	math	0
like	like	stance	0
mid	around	position	0
midst	around	position	0
minus	NULL	math	0
modulo	NULL	math	0
near	near	position	0
next	next	?	0
notwithstanding	NULL	logic	0
of	NULL	?	0
off	NULL	position	0
on	NULL	position/time	0
onto	NULL	spatiotemporal	0
opposite	opposite	logic	0
out	NULL	position	0
outside	NULL	position	0
over	under/while	position/spatiotemporal	1
pace	NULL	stance/regarding	0
past	before	time/position	0
pending	following	time/logic	1
per	NULL	math	0
plus	plus	math	0
pro	NULL	stance	0
qua	NULL	NULL	0
re	NULL	regarding	0
regarding	NULL	regarding	0
respecting	NULL	regarding	0
round	within/before	position/spatiotemporal	1
sans	NULL	logic	0
save	NULL	logic	0
saving	NULL	logic	0
since	NULL	time	0
than	NULL	comparison	0
through	NULL	spatiotemporal	0
throughout	NULL	spatiotemporal	0
till	NULL	time	0
times	times	math	0
to	NULL	position	0
touching	NULL	logic	0
toward	NULL	spatiotemporal	0
towards	NULL	spatiotemporal	0
under	on_top_of	position	1
underneath	on_top_of	position	0
unlike	unlike	stance	0
until	NULL	time	0
unto	NULL	time	0
up	NULL	position	0
upon	?when/under	time/position	1
versus	versus	logic	0
via	NULL	spatiotemporal	0
vice	NULL	logic	0
vis-a-vis	vis-a-vis	position	0
with	with	with	0
within	around	position	0
without	NULL	with	0
worth	NULL	~stance	0
according_to	NULL	~stance	0
ahead_of	behind	position	0
along_with	along_with	with	0
apart_from	NULL	logic	0
as_for	NULL	?	0
aside_from	NULL	logic	0
as_of	NULL	time	0
as_per	NULL	~stance	0
as_regards	NULL	regarding	0
as_to	NULL	regarding	0
away_from	near_to	position	1
back_to	NULL	position	0
because_of	~for	purpose	1
but_for	NULL	logic	0
close_to	close_to	position	0
contrary_to	contrary_to	~stance	0
depending_on	following	purpose	0
due_to	~for	purpose	0
except_for	NULL	logic	0
forward_of	behind_of	position	1
further_to	NULL	regarding	0
far_from	far_from	position	0
in_between	astride	position	0
in_to	NULL	position	0
inside_of	around	position	0
instead_of	NULL	logic	0
left_of	right_of	position	1
near_to	near_to	position	0
next_to	next_to	position	0
on_board		position	1
on_to	NULL	position	0
out_from	?NULL	position	1
out_of	?NULL	position	1
outside_of	around	position	0
owing_to	~for	purpose	0
preparatory_to	following	time	0
prior_to	after	time	0
pursuant_to	?NULL	~stance	1
regardless_of	NULL	logic	0
right_of	left_of	position	0
save_for	NULL	logic	0
subsequent_to	following	time	0
thanks_to	NULL	purpose	0
that_of	NULL	?	0
up_to	NULL	time	0
where_as	NULL	stance	0
as_far_as	as_far_as	position	0
as_long_as	as_long_as	position	0
as_opposed_to	as_opposed_to	stance	0
as_soon_as	as_soon_as	time	0
as_well_as	as_well_as	logic	0
by_means_of	NULL	purpose	0
by_virtue_of	NULL	purpose	0
for_the_sake_of	?NULL	purpose	1
in_accordance_with	NULL	~stance	0
in_addition_to	in_addition_to	~logic	0
in_case_of	NULL	purpose	0
in_face_of	NULL	purpose	0
in_favour_of	NULL	stance	0
in_front_of	behind	position	0
in_lieu_of	NULL	logic	0
in_order_to	NULL	purpose	0
in_place_of	NULL	logic	0
in_point_of	NULL	purpose	0
in_spite_of	NULL	logic	0
in_view_of	NULL	regarding	0
on_account_of	NULL	~stance/purpose	0
on_behalf_of	NULL	~stance	0
on_top_of	underneath	position	0
with_reference_to	NULL	regarding	0
with_regard_to	NULL	regarding	0
with_respect_to	NULL	regarding	0
with_a_view_to	NULL	regarding	0
